1111111111111
1C0100C0001C1
1000011110001
1P0011E000011
1111111111111
